 _     _                  ___     _____            
| |   (_)_ __  _   ___  _|_ _|___|  ___|   _ _ __  
| |   | | '_ \| | | \ \/ /| |/ __| |_ | | | | '_ \ 
| |___| | | | | |_| |>  < | |\__ \  _|| |_| | | | |
|_____|_|_| |_|\__,_/_/\_\___|___/_|   \__,_|_| |_|
                                                   
