 _  _ _____ ____  
| || |___  |___ \ 
| || |_ / /  __) |
|__   _/ /  / __/ 
   |_|/_/  |_____|
                  
